"","data.id","name","number.of.features","number.of.instances","number.of.numeric.features","number.of.symbolic.features","clusters","miss"
"2",3,"kr-vs-kp",37,3196,0,37,11,FALSE
"3",4,"labor",17,57,8,9,9,TRUE
"12",13,"breast-cancer",10,286,0,10,9,TRUE
"14",15,"breast-w",10,699,9,1,9,TRUE
"20",24,"mushroom",23,8124,0,23,11,TRUE
"21",25,"colic",27,368,7,20,11,TRUE
"25",29,"credit-approval",16,690,6,10,9,TRUE
"27",31,"credit-g",21,1000,7,14,11,FALSE
"32",37,"diabetes",9,768,8,1,6,FALSE
"33",38,"sick",30,3772,7,23,11,TRUE
"35",40,"sonar",61,208,60,1,6,FALSE
"38",43,"haberman",4,306,2,2,6,FALSE
"39",44,"spambase",58,4601,57,1,6,FALSE
"42",49,"heart-c",14,303,6,8,9,TRUE
"43",50,"tic-tac-toe",10,958,0,10,8,FALSE
"44",51,"heart-h",14,294,6,8,9,TRUE
"45",52,"trains",33,10,0,33,11,TRUE
"46",53,"heart-statlog",14,270,13,1,6,FALSE
"48",55,"hepatitis",20,155,6,14,11,TRUE
"49",56,"vote",17,435,0,17,11,TRUE
"51",59,"ionosphere",35,351,34,1,6,FALSE
"57",72,"BNG(kr-vs-kp)",37,1000000,0,37,3,FALSE
"58",73,"BNG(labor,nominal,1000000)",17,1000000,0,17,3,FALSE
"62",77,"BNG(breast-cancer,nominal,1000000)",10,1000000,0,10,3,FALSE
"69",120,"BNG(mushroom)",23,1000000,0,23,3,FALSE
"70",121,"BNG(colic.ORIG,nominal,1000000)",28,1000000,0,28,3,FALSE
"71",122,"BNG(colic,nominal,1000000)",23,1000000,0,23,3,FALSE
"73",124,"BNG(credit-a,nominal,1000000)",16,1000000,0,16,3,FALSE
"75",126,"BNG(credit-g,nominal,1000000)",21,1000000,0,21,3,FALSE
"77",128,"BNG(cylinder-bands,nominal,1000000)",40,1000000,0,40,3,FALSE
"80",131,"BNG(sick,nominal,1000000)",30,1000000,0,30,3,FALSE
"81",132,"BNG(sonar,nominal,1000000)",61,1000000,0,61,3,FALSE
"84",135,"BNG(spambase)",58,1000000,0,58,3,FALSE
"86",137,"BNG(tic-tac-toe)",10,39366,0,10,3,FALSE
"88",139,"BNG(trains)",33,1000000,0,33,3,FALSE
"89",140,"BNG(heart-statlog,nominal,1000000)",14,1000000,0,14,3,FALSE
"91",142,"BNG(hepatitis,nominal,1000000)",20,1000000,0,20,3,FALSE
"92",143,"BNG(vote)",17,131072,0,17,3,FALSE
"94",146,"BNG(ionosphere)",35,1000000,0,35,3,FALSE
"99",151,"electricity",9,45312,7,2,3,FALSE
"100",152,"Hyperplane_10_1E-3",11,1000000,10,1,3,FALSE
"101",153,"Hyperplane_10_1E-4",11,1000000,10,1,3,FALSE
"109",161,"SEA(50)",4,1000000,3,1,3,FALSE
"110",162,"SEA(50000)",4,1000000,3,1,3,FALSE
"112",164,"molecular-biology_promoters",59,106,0,59,13,FALSE
"114",172,"shuttle-landing-control",7,15,0,7,9,TRUE
"115",179,"adult",15,48842,2,13,3,TRUE
"168",246,"BNG(labor)",17,1000000,8,9,3,FALSE
"173",251,"BNG(breast-w)",10,39366,9,1,3,FALSE
"178",256,"BNG(colic.ORIG)",28,1000000,7,21,3,FALSE
"179",257,"BNG(colic)",23,1000000,7,16,3,FALSE
"180",258,"BNG(credit-a)",16,1000000,6,10,3,FALSE
"182",260,"BNG(credit-g)",21,1000000,7,14,3,FALSE
"184",262,"BNG(cylinder-bands)",40,1000000,18,22,3,FALSE
"186",264,"BNG(sonar)",61,1000000,60,1,3,FALSE
"189",267,"BNG(heart-statlog)",14,1000000,13,1,3,FALSE
"191",269,"BNG(hepatitis)",20,1000000,6,14,3,FALSE
"194",273,"IMDB.drama",1002,120919,1001,1,3,FALSE
"195",274,"20_newsgroups.drift",1002,399940,0,1001,3,FALSE
"203",293,"covertype",55,581012,54,1,12,FALSE
"212",310,"mammography",7,11183,6,1,4,FALSE
"213",311,"oil_spill",50,937,49,1,6,FALSE
"214",312,"scene",300,2407,294,6,2,FALSE
"217",316,"yeast_ml8",117,2417,103,14,11,FALSE
"221",333,"monks-problems-1",7,556,0,7,8,FALSE
"222",334,"monks-problems-2",7,601,0,7,8,FALSE
"223",335,"monks-problems-3",7,554,0,7,8,FALSE
"224",336,"SPECT",23,267,0,23,11,FALSE
"225",337,"SPECTF",45,349,44,1,6,FALSE
"232",346,"aids",5,50,2,3,6,FALSE
"233",350,"webdata_wXa",124,36974,123,1,3,FALSE
"234",351,"codrna",9,488565,8,1,12,FALSE
"235",354,"poker",11,1025010,10,1,3,FALSE
"236",357,"vehicle_sensIT",101,98528,100,1,3,FALSE
"241",376,"SyskillWebert-Sheep",3,65,0,1,6,FALSE
"309",444,"analcatdata_boxing2",4,132,0,4,8,FALSE
"310",446,"prnn_crabs",8,200,6,2,6,FALSE
"311",448,"analcatdata_boxing1",4,120,0,4,8,FALSE
"313",450,"analcatdata_lawsuit",5,264,3,2,6,FALSE
"314",451,"irish",6,500,2,4,9,TRUE
"322",459,"analcatdata_asbestos",4,83,1,3,6,FALSE
"324",461,"analcatdata_creditscore",7,100,3,4,8,FALSE
"326",463,"backache",33,180,6,27,11,FALSE
"327",464,"prnn_synth",3,250,2,1,6,FALSE
"328",465,"analcatdata_cyyoung8092",11,97,7,4,8,FALSE
"329",466,"schizo",15,340,12,3,9,TRUE
"330",467,"analcatdata_japansolvent",10,52,8,2,6,FALSE
"333",470,"profb",10,672,5,5,9,TRUE
"335",472,"lupus",4,87,3,1,6,FALSE
"338",476,"analcatdata_bankruptcy",7,50,5,2,6,FALSE
"340",479,"analcatdata_cyyoung9302",11,92,6,5,8,FALSE
"342",481,"biomed",9,209,7,2,9,TRUE
"532",682,"sleuth_ex2016",11,87,9,2,6,FALSE
"533",683,"sleuth_ex2015",8,60,7,1,6,FALSE
"562",713,"vineyard",4,52,3,1,6,FALSE
"563",714,"fruitfly",5,125,2,3,6,FALSE
"564",715,"fri_c3_1000_25",26,1000,25,1,6,FALSE
"565",716,"fri_c3_100_50",51,100,50,1,6,FALSE
"566",717,"rmftsa_ladata",11,508,10,1,6,FALSE
"567",718,"fri_c4_1000_100",101,1000,100,1,6,FALSE
"568",719,"veteran",8,137,3,5,8,FALSE
"569",720,"abalone",9,4177,7,2,6,FALSE
"570",721,"pwLinear",11,200,10,1,6,FALSE
"571",722,"pol",49,15000,48,1,4,FALSE
"572",723,"fri_c4_1000_25",26,1000,25,1,6,FALSE
"573",724,"analcatdata_vineyard",4,468,2,2,6,FALSE
"574",725,"bank8FM",9,8192,8,1,4,FALSE
"575",726,"fri_c2_100_5",6,100,5,1,6,FALSE
"576",727,"2dplanes",11,40768,10,1,3,FALSE
"577",728,"analcatdata_supreme",8,4052,7,1,6,FALSE
"578",729,"visualizing_slope",4,44,3,1,6,FALSE
"579",730,"fri_c1_250_5",6,250,5,1,6,FALSE
"580",731,"baskball",5,96,4,1,6,FALSE
"581",732,"fri_c0_250_50",51,250,50,1,6,FALSE
"582",733,"machine_cpu",7,209,6,1,6,FALSE
"583",734,"ailerons",41,13750,40,1,4,FALSE
"584",735,"cpu_small",13,8192,12,1,4,FALSE
"585",736,"visualizing_environmental",4,111,3,1,6,FALSE
"586",737,"space_ga",7,3107,6,1,6,FALSE
"587",738,"pharynx",12,195,1,11,9,TRUE
"588",739,"sleep",8,62,7,1,9,TRUE
"589",740,"fri_c3_1000_10",11,1000,10,1,6,FALSE
"590",741,"rmftsa_sleepdata",3,1024,1,2,6,FALSE
"591",742,"fri_c4_500_100",101,500,100,1,6,FALSE
"592",743,"fri_c1_1000_5",6,1000,5,1,6,FALSE
"593",744,"fri_c3_250_5",6,250,5,1,6,FALSE
"594",745,"auto_price",16,159,14,2,6,FALSE
"595",746,"fri_c1_250_25",26,250,25,1,6,FALSE
"596",747,"servo",5,167,0,5,8,FALSE
"597",748,"analcatdata_wildcat",6,163,3,3,6,FALSE
"598",749,"fri_c3_500_5",6,500,5,1,6,FALSE
"599",750,"pm10",8,500,7,1,6,FALSE
"600",751,"fri_c4_1000_10",11,1000,10,1,6,FALSE
"601",752,"puma32H",33,8192,32,1,4,FALSE
"602",753,"wisconsin",33,194,32,1,6,FALSE
"603",754,"fri_c0_100_5",6,100,5,1,6,FALSE
"604",755,"sleuth_ex1605",6,62,5,1,6,FALSE
"605",756,"autoPrice",16,159,15,1,6,FALSE
"606",757,"meta",22,528,19,3,9,TRUE
"607",758,"analcatdata_election2000",16,67,14,2,6,FALSE
"608",759,"analcatdata_olympic2000",13,66,11,2,6,FALSE
"609",760,"analcatdata_uktrainacc",17,31,16,1,9,TRUE
"610",761,"cpu_act",22,8192,21,1,4,FALSE
"611",762,"fri_c2_100_10",11,100,10,1,6,FALSE
"612",763,"fri_c0_250_10",11,250,10,1,6,FALSE
"613",764,"analcatdata_apnea3",4,450,1,3,6,FALSE
"614",765,"analcatdata_apnea2",4,475,1,3,6,FALSE
"615",766,"fri_c1_500_50",51,500,50,1,6,FALSE
"616",767,"analcatdata_apnea1",4,475,1,3,6,FALSE
"617",768,"fri_c3_100_25",26,100,25,1,6,FALSE
"618",769,"fri_c1_250_50",51,250,50,1,6,FALSE
"619",770,"strikes",7,625,6,1,6,FALSE
"620",771,"analcatdata_michiganacc",5,108,2,3,6,FALSE
"621",772,"quake",4,2178,3,1,6,FALSE
"622",773,"fri_c0_250_25",26,250,25,1,6,FALSE
"623",774,"disclosure_x_bias",4,662,3,1,6,FALSE
"624",775,"fri_c2_100_25",26,100,25,1,6,FALSE
"625",776,"fri_c0_250_5",6,250,5,1,6,FALSE
"626",777,"sleuth_ex1714",8,47,7,1,6,FALSE
"627",778,"bodyfat",15,252,14,1,6,FALSE
"628",779,"fri_c1_500_25",26,500,25,1,6,FALSE
"629",780,"rabe_265",7,51,6,1,6,FALSE
"630",782,"rabe_266",3,120,2,1,6,FALSE
"631",783,"fri_c3_100_10",11,100,10,1,6,FALSE
"632",784,"newton_hema",4,140,2,2,6,FALSE
"633",785,"wind_correlations",47,45,46,1,6,FALSE
"634",786,"cleveland",14,303,6,8,9,TRUE
"635",787,"witmer_census_1980",6,50,4,2,6,FALSE
"636",788,"triazines",61,186,60,1,6,FALSE
"637",789,"fri_c1_100_10",11,100,10,1,6,FALSE
"638",790,"elusage",3,55,1,2,6,FALSE
"639",791,"diabetes_numeric",3,43,2,1,6,FALSE
"640",792,"fri_c2_500_5",6,500,5,1,6,FALSE
"641",793,"fri_c3_250_10",11,250,10,1,6,FALSE
"642",794,"fri_c2_250_25",26,250,25,1,6,FALSE
"643",795,"disclosure_x_tampered",4,662,3,1,6,FALSE
"644",796,"cpu",8,209,6,2,6,FALSE
"645",797,"fri_c4_1000_50",51,1000,50,1,6,FALSE
"646",798,"cholesterol",14,303,6,8,9,TRUE
"647",799,"fri_c0_1000_5",6,1000,5,1,6,FALSE
"648",800,"pyrim",28,74,27,1,6,FALSE
"649",801,"chscase_funds",4,185,2,2,6,FALSE
"650",802,"pbcseq",19,1945,12,7,9,TRUE
"651",803,"delta_ailerons",6,7129,5,1,4,FALSE
"652",804,"hutsof99_logis",8,70,3,5,8,FALSE
"653",805,"fri_c4_500_50",51,500,50,1,6,FALSE
"654",806,"fri_c3_1000_50",51,1000,50,1,6,FALSE
"655",807,"kin8nm",9,8192,8,1,4,FALSE
"656",808,"fri_c0_100_10",11,100,10,1,6,FALSE
"657",810,"pbc",19,418,10,9,9,TRUE
"658",811,"rmftsa_ctoarrivals",3,264,1,2,6,FALSE
"659",812,"fri_c1_100_25",26,100,25,1,6,FALSE
"660",813,"fri_c3_1000_5",6,1000,5,1,6,FALSE
"661",814,"chscase_vine2",3,468,2,1,6,FALSE
"662",815,"chscase_vine1",10,52,9,1,6,FALSE
"663",816,"puma8NH",9,8192,8,1,4,FALSE
"664",817,"diggle_table_a1",5,48,4,1,6,FALSE
"665",818,"diggle_table_a2",9,310,7,2,6,FALSE
"666",819,"delta_elevators",7,9517,6,1,4,FALSE
"667",820,"chatfield_4",13,235,12,1,6,FALSE
"668",821,"house_16H",17,22784,16,1,4,FALSE
"669",823,"houses",9,20640,8,1,4,FALSE
"670",824,"fri_c1_500_10",11,500,10,1,6,FALSE
"671",825,"boston_corrected",21,506,17,4,8,FALSE
"672",826,"sensory",12,576,0,12,8,FALSE
"673",827,"disclosure_x_noise",4,662,3,1,6,FALSE
"674",828,"fri_c4_100_100",101,100,100,1,6,FALSE
"675",829,"fri_c1_100_5",6,100,5,1,6,FALSE
"676",830,"fri_c2_250_10",11,250,10,1,6,FALSE
"677",831,"autoMpg",8,398,4,4,9,TRUE
"678",832,"fri_c3_250_25",26,250,25,1,6,FALSE
"679",833,"bank32nh",33,8192,32,1,4,FALSE
"680",834,"fri_c4_250_100",101,250,100,1,6,FALSE
"681",835,"analcatdata_vehicle",5,48,0,5,8,FALSE
"682",836,"sleuth_case1102",9,34,5,4,8,FALSE
"683",837,"fri_c1_1000_50",51,1000,50,1,6,FALSE
"684",838,"fri_c4_500_25",26,500,25,1,6,FALSE
"685",839,"kdd_el_nino-small",9,782,6,3,9,TRUE
"686",840,"autoHorse",26,205,17,9,9,TRUE
"687",841,"stock",10,950,9,1,6,FALSE
"688",842,"analcatdata_runshoes",11,60,4,7,9,TRUE
"689",843,"house_8L",9,22784,8,1,4,FALSE
"690",844,"breastTumor",10,286,1,9,9,TRUE
"691",845,"fri_c0_1000_10",11,1000,10,1,6,FALSE
"692",846,"elevators",19,16599,18,1,4,FALSE
"693",847,"wind",15,6574,14,1,4,FALSE
"694",848,"schlvote",6,38,4,2,6,FALSE
"695",849,"fri_c0_1000_25",26,1000,25,1,6,FALSE
"696",850,"fri_c0_100_50",51,100,50,1,6,FALSE
"697",851,"tecator",125,240,124,1,6,FALSE
"698",852,"analcatdata_gsssexsurvey",10,159,4,6,9,TRUE
"699",853,"boston",14,506,12,2,6,FALSE
"700",854,"fishcatch",8,158,5,3,9,TRUE
"701",855,"fri_c4_500_10",11,500,10,1,6,FALSE
"702",857,"bolts",8,40,7,1,6,FALSE
"703",858,"hungarian",14,294,6,8,9,TRUE
"704",859,"analcatdata_gviolence",10,74,8,2,6,FALSE
"705",860,"vinnie",3,380,2,1,6,FALSE
"706",861,"auto93",23,93,16,7,9,TRUE
"708",863,"fri_c4_250_10",11,250,10,1,6,FALSE
"710",865,"analcatdata_neavote",4,100,1,3,6,FALSE
"711",866,"fri_c2_1000_50",51,1000,50,1,6,FALSE
"712",867,"visualizing_livestock",3,130,0,3,6,FALSE
"713",868,"fri_c4_100_25",26,100,25,1,6,FALSE
"714",869,"fri_c2_500_10",11,500,10,1,6,FALSE
"715",870,"fri_c1_500_5",6,500,5,1,6,FALSE
"716",871,"pollen",6,3848,5,1,6,FALSE
"717",873,"fri_c3_250_50",51,250,50,1,6,FALSE
"718",874,"rabe_131",6,50,5,1,6,FALSE
"719",875,"analcatdata_chlamydia",4,100,0,4,8,FALSE
"720",876,"fri_c1_100_50",51,100,50,1,6,FALSE
"721",877,"fri_c2_250_50",51,250,50,1,6,FALSE
"722",878,"fri_c4_100_10",11,100,10,1,6,FALSE
"723",879,"fri_c2_500_25",26,500,25,1,6,FALSE
"724",880,"mu284",11,284,10,1,6,FALSE
"725",881,"mv",11,40768,7,4,3,FALSE
"726",882,"pollution",16,60,15,1,6,FALSE
"727",884,"fri_c0_500_5",6,500,5,1,6,FALSE
"728",885,"transplant",4,131,3,1,6,FALSE
"729",886,"no2",8,500,7,1,6,FALSE
"730",887,"mbagrade",3,61,1,2,6,FALSE
"731",888,"fri_c0_500_50",51,500,50,1,6,FALSE
"732",889,"fri_c0_100_25",26,100,25,1,6,FALSE
"733",890,"cloud",8,108,6,2,6,FALSE
"734",891,"sleuth_case1202",7,93,4,3,6,FALSE
"735",892,"sleuth_case1201",8,50,6,2,6,FALSE
"736",893,"visualizing_hamster",6,73,5,1,6,FALSE
"737",894,"rabe_148",6,66,5,1,6,FALSE
"738",895,"chscase_geyser1",3,222,2,1,6,FALSE
"739",896,"fri_c3_500_25",26,500,25,1,6,FALSE
"740",897,"colleges_aaup",17,1161,13,4,9,TRUE
"741",898,"hip",8,54,7,1,9,TRUE
"742",899,"analcatdata_negotiation",6,92,4,2,9,TRUE
"743",900,"chscase_census6",7,400,6,1,6,FALSE
"744",901,"fried",11,40768,10,1,3,FALSE
"745",902,"sleuth_case2002",7,147,2,5,8,FALSE
"746",903,"fri_c2_1000_25",26,1000,25,1,6,FALSE
"747",904,"fri_c0_1000_50",51,1000,50,1,6,FALSE
"748",905,"chscase_adopt",4,39,2,2,6,FALSE
"749",906,"chscase_census5",8,400,7,1,6,FALSE
"750",907,"chscase_census4",8,400,7,1,6,FALSE
"751",908,"chscase_census3",8,400,7,1,6,FALSE
"752",909,"chscase_census2",8,400,7,1,6,FALSE
"753",910,"fri_c1_1000_10",11,1000,10,1,6,FALSE
"754",911,"fri_c2_250_5",6,250,5,1,6,FALSE
"755",912,"fri_c2_1000_5",6,1000,5,1,6,FALSE
"756",913,"fri_c2_1000_10",11,1000,10,1,6,FALSE
"757",914,"balloon",3,2001,2,1,6,FALSE
"758",915,"plasma_retinol",14,315,10,4,8,FALSE
"759",916,"fri_c3_100_5",6,100,5,1,6,FALSE
"760",917,"fri_c1_1000_25",26,1000,25,1,6,FALSE
"761",918,"fri_c4_250_50",51,250,50,1,6,FALSE
"762",919,"rabe_166",3,40,2,1,6,FALSE
"763",920,"fri_c2_500_50",51,500,50,1,6,FALSE
"764",921,"analcatdata_seropositive",4,132,2,2,6,FALSE
"765",922,"fri_c2_100_50",51,100,50,1,6,FALSE
"766",923,"visualizing_soil",5,8641,3,2,4,FALSE
"767",924,"humandevel",4,130,2,2,6,FALSE
"768",925,"visualizing_galaxy",5,323,4,1,6,FALSE
"769",926,"fri_c0_500_25",26,500,25,1,6,FALSE
"770",927,"hutsof99_child_witness",17,42,16,1,6,FALSE
"771",928,"rabe_97",5,46,3,2,6,FALSE
"772",929,"rabe_176",5,70,4,1,6,FALSE
"773",930,"colleges_usnews",35,1302,32,3,9,TRUE
"774",931,"disclosure_z",4,662,3,1,6,FALSE
"775",932,"fri_c4_100_50",51,100,50,1,6,FALSE
"776",933,"fri_c4_250_25",26,250,25,1,6,FALSE
"777",934,"socmob",6,1156,1,5,8,FALSE
"778",935,"fri_c1_250_10",11,250,10,1,6,FALSE
"779",936,"fri_c3_500_10",11,500,10,1,6,FALSE
"780",937,"fri_c3_500_50",51,500,50,1,6,FALSE
"781",938,"sleuth_ex1221",11,42,8,3,6,FALSE
"782",939,"chscase_whale",10,228,9,1,9,TRUE
"783",940,"water-treatment",39,527,21,18,11,TRUE
"784",941,"lowbwt",10,189,2,8,8,FALSE
"785",942,"chscase_health",5,50,2,3,6,FALSE
"786",943,"fri_c0_500_10",11,500,10,1,6,FALSE
"787",944,"echoMonths",10,130,6,4,9,TRUE
"788",945,"kidney",7,76,3,4,8,FALSE
"789",946,"visualizing_ethanol",3,88,2,1,6,FALSE
"790",947,"arsenic-male-bladder",5,559,3,2,6,FALSE
"791",949,"arsenic-female-bladder",5,559,3,2,6,FALSE
"792",950,"arsenic-female-lung",5,559,3,2,6,FALSE
"793",951,"arsenic-male-lung",5,559,3,2,6,FALSE
"795",953,"splice",62,3190,0,62,13,FALSE
"796",954,"spectrometer",103,531,100,3,6,FALSE
"797",955,"tae",6,151,3,3,6,FALSE
"799",957,"braziltourism",9,412,4,5,9,TRUE
"800",958,"segment",20,2310,19,1,6,FALSE
"801",959,"nursery",9,12960,0,9,4,FALSE
"802",960,"postoperative-patient-data",9,90,0,9,9,TRUE
"803",961,"analcatdata_broadwaymult",8,285,3,5,9,TRUE
"804",962,"mfeat-morphological",7,2000,6,1,6,FALSE
"806",964,"pasture",23,36,21,2,6,FALSE
"807",965,"zoo",18,101,1,17,11,FALSE
"808",966,"analcatdata_halloffame",18,1340,15,3,9,TRUE
"809",967,"cars",9,406,6,3,9,TRUE
"810",968,"analcatdata_birthday",4,365,1,3,9,TRUE
"811",969,"iris",5,150,4,1,6,FALSE
"812",970,"analcatdata_authorship",71,841,70,1,6,FALSE
"813",971,"mfeat-fourier",77,2000,76,1,6,FALSE
"814",972,"squash-stored",25,52,21,4,9,TRUE
"815",973,"wine",14,178,13,1,6,FALSE
"816",974,"hayes-roth",5,132,4,1,6,FALSE
"817",975,"autos",26,205,15,11,9,TRUE
"818",976,"JapaneseVowels",15,9961,14,1,4,FALSE
"819",977,"letter",17,20000,16,1,4,FALSE
"820",978,"mfeat-factors",217,2000,216,1,2,FALSE
"821",979,"waveform-5000",41,5000,40,1,6,FALSE
"822",980,"optdigits",65,5620,64,1,6,FALSE
"823",981,"kdd_internet_usage",69,10108,0,69,13,TRUE
"825",983,"cmc",10,1473,2,8,8,FALSE
"826",984,"analcatdata_draft",6,366,3,3,9,TRUE
"827",985,"squash-unstored",24,52,20,4,9,TRUE
"828",986,"analcatdata_marketing",33,364,0,33,11,TRUE
"829",987,"collins",24,500,20,4,8,FALSE
"830",988,"fl2000",16,67,14,2,6,FALSE
"831",989,"anneal",39,898,6,33,11,TRUE
"832",990,"eucalyptus",20,736,14,6,9,TRUE
"833",991,"car",7,1728,0,7,8,FALSE
"834",992,"analcatdata_broadway",10,95,3,7,9,TRUE
"835",993,"kdd_ipums_la_97-small",61,7019,33,28,11,TRUE
"836",994,"vehicle",19,846,18,1,6,FALSE
"837",995,"mfeat-zernike",48,2000,47,1,6,FALSE
"838",996,"prnn_fglass",10,214,9,1,6,FALSE
"839",997,"balance-scale",5,625,4,1,6,FALSE
"840",998,"analcatdata_bondrate",12,57,4,8,9,TRUE
"841",999,"audiology",70,226,0,70,13,TRUE
"842",1000,"hypothyroid",30,3772,7,23,11,TRUE
"843",1001,"sponge",46,76,0,46,11,TRUE
"844",1002,"ipums_la_98-small",56,7485,16,40,11,TRUE
"845",1003,"primary-tumor",18,339,0,18,11,TRUE
"846",1004,"synthetic_control",62,600,60,2,6,FALSE
"847",1005,"glass",10,214,9,1,6,FALSE
"848",1006,"lymph",19,148,3,16,11,FALSE
"849",1007,"bridges",13,107,3,10,9,TRUE
"850",1008,"analcatdata_reviewer",9,379,0,9,9,TRUE
"851",1009,"white-clover",32,63,27,5,8,FALSE
"852",1010,"dermatology",35,366,1,34,11,TRUE
"853",1011,"ecoli",8,336,7,1,6,FALSE
"854",1012,"flags",30,194,2,28,11,FALSE
"855",1013,"analcatdata_challenger",3,138,1,2,6,FALSE
"856",1014,"analcatdata_dmft",5,797,0,5,8,FALSE
"857",1015,"confidence",4,72,3,1,6,FALSE
"858",1016,"vowel",14,990,10,4,8,FALSE
"859",1017,"arrhythmia",280,452,206,74,13,TRUE
"860",1018,"ipums_la_99-small",57,8844,15,42,11,TRUE
"861",1019,"pendigits",17,10992,16,1,4,FALSE
"862",1020,"mfeat-karhunen",65,2000,64,1,6,FALSE
"863",1021,"page-blocks",11,5473,10,1,6,FALSE
"864",1022,"mfeat-pixel",241,2000,0,241,11,FALSE
"865",1023,"soybean",36,683,0,36,11,TRUE
"866",1025,"analcatdata_germangss",6,400,0,6,8,FALSE
"867",1026,"grub-damage",9,155,2,7,8,FALSE
"873",1037,"ada_prior",15,4562,6,9,9,TRUE
"874",1038,"gina_agnostic",971,3468,970,1,13,FALSE
"875",1039,"hiva_agnostic",1618,4229,1617,1,13,FALSE
"876",1040,"sylva_prior",109,14395,108,1,4,FALSE
"878",1042,"gina_prior",785,3468,784,1,13,FALSE
"880",1045,"kc1-top5",95,145,94,1,6,FALSE
"881",1046,"mozilla4",6,15545,5,1,4,FALSE
"883",1048,"jEdit_4.2_4.3",9,369,8,1,6,FALSE
"884",1049,"pc4",38,1458,37,1,6,FALSE
"885",1050,"pc3",38,1563,37,1,6,FALSE
"887",1053,"jm1",22,10885,21,1,9,TRUE
"888",1054,"mc2",40,161,39,1,6,FALSE
"889",1055,"cm1_req",9,89,7,2,6,FALSE
"890",1056,"mc1",39,9466,38,1,4,FALSE
"892",1059,"ar1",30,121,29,1,6,FALSE
"893",1060,"ar3",30,63,29,1,6,FALSE
"894",1061,"ar4",30,107,29,1,6,FALSE
"895",1062,"ar5",30,36,29,1,6,FALSE
"896",1063,"kc2",22,522,21,1,6,FALSE
"897",1064,"ar6",30,101,29,1,6,FALSE
"898",1065,"kc3",40,458,39,1,6,FALSE
"899",1066,"kc1-binary",95,145,94,1,6,FALSE
"900",1067,"kc1",22,2109,21,1,6,FALSE
"901",1068,"pc1",22,1109,21,1,6,FALSE
"902",1069,"pc2",37,5589,36,1,6,FALSE
"904",1071,"mw1",38,403,37,1,6,FALSE
"906",1073,"jEdit_4.0_4.2",9,274,8,1,6,FALSE
"907",1075,"datatrieve",9,130,8,1,6,FALSE
"917",1085,"anthracyclineTaxaneChemotherapy",61360,159,61359,1,7,FALSE
"932",1101,"lymphoma_2classes",4027,45,4026,1,10,TRUE
"935",1104,"leukemia",7130,72,7129,1,10,FALSE
"937",1107,"tumors_C",7130,60,7129,1,10,FALSE
"940",1111,"KDDCup09_appetency",231,50000,192,39,3,TRUE
"941",1112,"KDDCup09_churn",231,50000,192,39,3,TRUE
"943",1114,"KDDCup09_upselling",231,50000,192,39,3,TRUE
"945",1116,"musk",170,6598,167,3,2,FALSE
"947",1119,"adult-census",16,32561,7,9,3,TRUE
"948",1120,"MagicTelescope",12,19020,11,1,4,FALSE
"949",1121,"badges2",12,294,8,4,8,FALSE
"950",1122,"AP_Breast_Prostate",10937,413,10936,1,1,FALSE
"951",1123,"AP_Endometrium_Breast",10937,405,10936,1,1,FALSE
"952",1124,"AP_Omentum_Uterus",10937,201,10936,1,1,FALSE
"953",1125,"AP_Omentum_Prostate",10937,146,10936,1,1,FALSE
"954",1126,"AP_Colon_Lung",10937,412,10936,1,1,FALSE
"955",1127,"AP_Breast_Omentum",10937,421,10936,1,1,FALSE
"956",1128,"OVA_Breast",10937,1545,10936,1,1,FALSE
"957",1129,"AP_Uterus_Kidney",10937,384,10936,1,1,FALSE
"958",1130,"OVA_Lung",10937,1545,10936,1,1,FALSE
"959",1131,"AP_Prostate_Uterus",10937,193,10936,1,1,FALSE
"960",1132,"AP_Omentum_Lung",10937,203,10936,1,1,FALSE
"961",1133,"AP_Endometrium_Colon",10937,347,10936,1,1,FALSE
"962",1134,"OVA_Kidney",10937,1545,10936,1,1,FALSE
"963",1135,"AP_Colon_Prostate",10937,355,10936,1,1,FALSE
"964",1136,"AP_Lung_Uterus",10937,250,10936,1,1,FALSE
"965",1137,"AP_Colon_Kidney",10937,546,10936,1,1,FALSE
"966",1138,"OVA_Uterus",10937,1545,10936,1,1,FALSE
"967",1139,"OVA_Omentum",10937,1545,10936,1,1,FALSE
"968",1140,"AP_Ovary_Lung",10937,324,10936,1,1,FALSE
"969",1141,"AP_Endometrium_Prostate",10937,130,10936,1,1,FALSE
"970",1142,"OVA_Endometrium",10937,1545,10936,1,1,FALSE
"971",1143,"AP_Colon_Omentum",10937,363,10936,1,1,FALSE
"972",1144,"AP_Prostate_Kidney",10937,329,10936,1,1,FALSE
"973",1145,"AP_Breast_Colon",10937,630,10936,1,1,FALSE
"974",1146,"OVA_Prostate",10937,1545,10936,1,1,FALSE
"975",1147,"AP_Omentum_Kidney",10937,337,10936,1,1,FALSE
"976",1148,"AP_Breast_Uterus",10937,468,10936,1,1,FALSE
"977",1149,"AP_Ovary_Kidney",10937,458,10936,1,1,FALSE
"978",1150,"AP_Breast_Lung",10937,470,10936,1,1,FALSE
"979",1151,"AP_Endometrium_Omentum",10937,138,10936,1,1,FALSE
"980",1152,"AP_Prostate_Ovary",10937,267,10936,1,1,FALSE
"981",1153,"AP_Colon_Ovary",10937,484,10936,1,1,FALSE
"982",1154,"AP_Endometrium_Lung",10937,187,10936,1,1,FALSE
"983",1155,"AP_Prostate_Lung",10937,195,10936,1,1,FALSE
"984",1156,"AP_Omentum_Ovary",10937,275,10936,1,1,FALSE
"985",1157,"AP_Endometrium_Kidney",10937,321,10936,1,1,FALSE
"986",1158,"AP_Breast_Kidney",10937,604,10936,1,1,FALSE
"987",1159,"AP_Endometrium_Ovary",10937,259,10936,1,1,FALSE
"988",1160,"AP_Colon_Uterus",10937,410,10936,1,1,FALSE
"989",1161,"OVA_Colon",10937,1545,10936,1,1,FALSE
"990",1162,"AP_Ovary_Uterus",10937,322,10936,1,1,FALSE
"991",1163,"AP_Lung_Kidney",10937,386,10936,1,1,FALSE
"992",1164,"AP_Endometrium_Uterus",10937,185,10936,1,1,FALSE
"993",1165,"AP_Breast_Ovary",10937,542,10936,1,1,FALSE
"994",1166,"OVA_Ovary",10937,1545,10936,1,1,FALSE
"995",1167,"pc1_req",9,320,7,2,6,FALSE
"997",1169,"airlines",8,539383,3,5,12,FALSE
"999",1178,"BNG(solar-flare)",13,663552,0,13,12,FALSE
"1001",1180,"BNG(spect_test)",23,1000000,0,23,3,FALSE
"1002",1181,"BNG(spectf_test)",45,1000000,44,1,3,FALSE
"1003",1182,"BNG(adult)",15,1000000,2,13,3,FALSE
"1026",1205,"BNG(Australian)",15,1000000,14,1,3,FALSE
"1032",1211,"BNG(SPECT)",23,1000000,0,23,3,FALSE
"1033",1212,"BNG(SPECTF)",45,1000000,44,1,3,FALSE
"1036",1216,"Click_prediction_small",12,1496391,11,1,3,FALSE
"1045",1235,"Agrawal1",10,1000000,6,4,3,FALSE
"1046",1236,"Stagger1",4,1000000,0,4,3,FALSE
"1047",1237,"Stagger2",4,1000000,0,4,3,FALSE
"1048",1238,"Stagger3",4,1000000,0,4,3,FALSE
"1049",1240,"AirlinesCodrnaAdult",30,1076790,13,17,3,TRUE
"1050",1241,"codrnaNorm",9,488565,8,1,12,FALSE
"1051",1242,"vehicleNorm",101,98528,100,1,3,FALSE
"1071",1369,"BNG(kr-vs-kp,1000,1)",37,1000000,0,37,3,FALSE
"1072",1370,"BNG(kr-vs-kp,1000,5)",37,1000000,0,37,3,FALSE
"1073",1371,"BNG(kr-vs-kp,1000,10)",37,1000000,0,37,3,FALSE
"1074",1372,"BNG(kr-vs-kp,5000,1)",37,1000000,0,37,3,FALSE
"1075",1373,"BNG(kr-vs-kp,5000,5)",37,1000000,0,37,3,FALSE
"1076",1374,"BNG(kr-vs-kp,5000,10)",37,1000000,0,37,3,FALSE
"1077",1375,"BNG(kr-vs-kp,10000,1)",37,1000000,0,37,3,FALSE
"1078",1376,"BNG(kr-vs-kp,10000,5)",37,1000000,0,37,3,FALSE
"1079",1377,"BNG(kr-vs-kp,10000,10)",37,1000000,0,37,3,FALSE
"1113",1412,"lungcancer_GSE31210",24,226,21,3,6,FALSE
"1130",1441,"KungChi3",40,123,39,1,6,FALSE
"1131",1442,"MegaWatt1",38,253,37,1,6,FALSE
"1132",1443,"PizzaCutter1",38,661,37,1,6,FALSE
"1133",1444,"PizzaCutter3",38,1043,37,1,6,FALSE
"1134",1446,"CostaMadre1",38,296,37,1,6,FALSE
"1135",1447,"CastMetal1",38,327,37,1,6,FALSE
"1136",1448,"KnuggetChase3",40,194,39,1,6,FALSE
"1137",1449,"MeanWhile1",38,253,37,1,6,FALSE
"1138",1450,"MindCave2",40,125,39,1,6,FALSE
"1139",1451,"PieChart1",38,705,37,1,6,FALSE
"1140",1452,"PieChart2",37,745,36,1,6,FALSE
"1141",1453,"PieChart3",38,1077,37,1,6,FALSE
"1142",1455,"acute-inflammations",7,120,1,6,8,FALSE
"1144",1458,"arcene",10001,200,10000,1,1,FALSE
"1146",1460,"banana",3,5300,2,1,6,FALSE
"1147",1461,"bank-marketing",17,45211,7,10,3,FALSE
"1148",1462,"banknote-authentication",5,1372,4,1,6,FALSE
"1149",1463,"blogger",6,100,0,6,8,FALSE
"1150",1464,"blood-transfusion-service-center",5,748,4,1,6,FALSE
"1153",1467,"climate-model-simulation-crashes",21,540,20,1,6,FALSE
"1155",1471,"eeg-eye-state",15,14980,14,1,4,FALSE
"1157",1473,"fertility",10,100,9,1,6,FALSE
"1162",1479,"hill-valley",101,1212,100,1,6,FALSE
"1163",1480,"ilpd",11,583,9,2,6,FALSE
"1167",1484,"lsvt",311,126,310,1,2,FALSE
"1168",1485,"madelon",501,2600,500,1,2,FALSE
"1169",1486,"nomao",119,34465,89,30,11,FALSE
"1170",1487,"ozone-level-8hr",73,2534,72,1,6,FALSE
"1171",1488,"parkinsons",23,195,22,1,6,FALSE
"1172",1489,"phoneme",6,5404,5,1,6,FALSE
"1173",1490,"planning-relax",13,182,12,1,6,FALSE
"1177",1494,"qsar-biodeg",42,1055,41,1,6,FALSE
"1178",1495,"qualitative-bankruptcy",7,250,0,7,8,FALSE
"1179",1496,"ringnorm",21,7400,20,1,4,FALSE
"1181",1498,"sa-heart",10,462,8,2,6,FALSE
"1185",1502,"skin-segmentation",4,245057,3,1,10,FALSE
"1187",1504,"steel-plates-fault",34,1941,33,1,6,FALSE
"1188",1506,"thoracic-surgery",17,470,3,14,11,FALSE
"1189",1507,"twonorm",21,7400,20,1,4,FALSE
"1192",1510,"wdbc",31,569,30,1,6,FALSE
"1193",1511,"wholesale-customers",9,440,7,2,6,FALSE
"1204",1524,"vertebra-column",7,310,6,1,6,FALSE
"1227",1547,"autoUniv-au1-1000",21,1000,20,1,6,FALSE
"1240",1561,"dbworld-bodies-stemmed",3722,64,0,3722,5,FALSE
"1241",1562,"dbworld-bodies",4703,64,0,4703,5,FALSE
"1242",1563,"dbworld-subjects-stemmed",230,64,0,230,11,FALSE
"1243",1564,"dbworld-subjects",243,64,0,243,11,FALSE
"1272",1597,"creditcard",31,284807,30,1,10,FALSE
"2356",4134,"Bioresponse",1777,3751,1776,1,13,FALSE
"2357",4135,"Amazon_employee_access",10,32769,0,10,3,FALSE
"2358",4136,"Dexter",20001,600,20000,1,1,FALSE
"2359",4137,"Dorothea",100001,1150,100000,1,7,FALSE
"2364",4154,"CreditCardSubset",31,14240,30,1,4,FALSE
"2365",4329,"thoracic_surgery",17,470,3,14,11,FALSE
"2371",4534,"PhishingWebsites",31,11055,0,31,11,FALSE
"2391",6332,"cylinder-bands",40,540,18,22,11,TRUE
"2393",23381,"dresses-sales",13,500,1,12,9,TRUE
"2400",23499,"breast-cancer-dropped-missing-attributes-values",10,277,0,10,8,FALSE
"2401",23512,"higgs",29,98050,28,1,3,TRUE
"2405",23517,"numerai28.6",22,96320,21,1,3,FALSE
"2423",40536,"SpeedDating",123,8378,59,64,13,TRUE
"2424",40588,"birds",279,645,258,21,11,FALSE
"2425",40589,"emotions",78,593,72,6,8,FALSE
"2426",40590,"enron",1054,1702,0,1054,3,FALSE
"2427",40591,"genbase",1213,662,0,1213,3,FALSE
"2428",40592,"image",140,2000,135,5,6,FALSE
"2429",40593,"langLog",1079,1460,1004,75,13,FALSE
"2430",40594,"reuters",250,2000,243,7,2,FALSE
"2432",40596,"slashdot",1101,3782,1079,22,13,FALSE
"2433",40597,"yeast",117,2417,103,14,11,FALSE
"2435",40645,"GAMETES_Epistasis_2-Way_1000atts_0.4H_EDM-1_EDM-1_1",1001,1600,0,1001,3,FALSE
"2436",40646,"GAMETES_Epistasis_2-Way_20atts_0.1H_EDM-1_1",21,1600,0,21,11,FALSE
"2437",40647,"GAMETES_Epistasis_2-Way_20atts_0.4H_EDM-1_1",21,1600,0,21,11,FALSE
"2438",40648,"GAMETES_Epistasis_3-Way_20atts_0.2H_EDM-1_1",21,1600,0,21,11,FALSE
"2439",40649,"GAMETES_Heterogeneity_20atts_1600_Het_0.4_0.2_50_EDM-2_001",21,1600,0,21,11,FALSE
"2440",40650,"GAMETES_Heterogeneity_20atts_1600_Het_0.4_0.2_75_EDM-2_001",21,1600,0,21,11,FALSE
"2441",40660,"analcatdata_fraud",12,42,0,12,8,FALSE
"2444",40665,"clean1",169,476,168,1,2,FALSE
"2445",40666,"clean2",169,6598,168,1,2,FALSE
"2447",40669,"corral",7,160,0,7,8,FALSE
"2453",40680,"mofn-3-7-10",11,1324,0,11,8,FALSE
"2454",40681,"mux6",7,128,0,7,8,FALSE
"2460",40690,"threeOf9",10,512,0,10,8,FALSE
"2462",40693,"xd6",10,973,0,10,8,FALSE
"2464",40701,"churn",21,5000,16,5,8,FALSE
"2465",40702,"solar-flare",11,1066,0,11,8,FALSE
"2467",40705,"tokyo1",45,959,42,3,6,FALSE
"2468",40706,"parity5_plus_5",11,1124,0,11,8,FALSE
"2472",40710,"cleve",14,303,5,9,8,FALSE
"2474",40713,"dis",30,3772,6,24,11,FALSE
"2475",40714,"parity5",6,32,0,6,8,FALSE
"2480",40900,"Satellite",37,5100,36,1,6,FALSE
"2481",40910,"Speech",401,3686,400,1,2,FALSE
"2485",40922,"Run_or_walk_information",7,88588,6,1,3,FALSE
"2489",40945,"Titanic",14,1309,6,3,9,TRUE
"2494",40978,"Internet-Advertisements",1559,3279,3,1556,3,FALSE
"2496",40981,"Australian",15,690,6,9,8,FALSE
"2498",40983,"wilt",6,4839,5,1,6,FALSE
"2507",40999,"jungle_chess_2pcs_endgame_elephant_elephant",47,2351,20,27,11,FALSE
"2513",41005,"jungle_chess_2pcs_endgame_rat_rat",47,3660,20,27,11,FALSE
"2515",41007,"jungle_chess_2pcs_endgame_lion_lion",47,2352,20,27,11,FALSE
"2518",41026,"gisette",5001,7000,5000,1,10,FALSE
"2528",41138,"APSFailure",171,76000,170,1,3,TRUE
"2529",41142,"christine",1637,5418,1599,38,13,FALSE
"2530",41143,"jasmine",145,2984,8,137,13,FALSE
"2531",41144,"madeline",260,3140,259,1,2,FALSE
"2532",41145,"philippine",309,5832,308,1,2,FALSE
"2533",41146,"sylvine",21,5124,20,1,6,FALSE
"2534",41147,"albert",79,425240,26,53,10,FALSE
"2535",41150,"MiniBooNE",51,130064,50,1,3,FALSE
"2536",41156,"ada",49,4147,48,1,6,FALSE
"2538",41158,"gina",971,3153,970,1,13,FALSE
"2539",41159,"guillermo",4297,20000,4296,1,10,FALSE
"2540",41160,"rl",23,31406,8,15,3,TRUE
"2541",41161,"riccardo",4297,20000,4296,1,10,FALSE
"2542",41162,"kick",33,72983,14,19,3,TRUE
"2553",41228,"Klaverjas2018",33,981541,32,1,3,FALSE
"2555",41430,"DiabeticMellitus",98,281,97,1,9,TRUE
"2584",41496,"DRSongsLyrics",2,358,0,1,6,FALSE
"2594",41521,"Weather",5,14,2,3,6,FALSE
"2598",41526,"test_dataset",61,15547,60,1,9,TRUE
"2600",41538,"conference_attendance",7,246,0,7,8,FALSE
"2641",41707,"FOREX_usddkk-day-High",12,1832,11,1,6,FALSE
"2642",41708,"FOREX_eurchf-minute-Close",12,375840,11,1,10,FALSE
"2643",41709,"FOREX_audchf-hour-High",12,43825,11,1,3,FALSE
"2644",41710,"FOREX_eurhkd-minute-High",12,375840,11,1,10,FALSE
"2645",41711,"FOREX_eurusd-minute-Close",12,375840,11,1,10,FALSE
"2646",41712,"FOREX_eurcad-hour-High",12,43825,11,1,3,FALSE
"2647",41713,"FOREX_eurnzd-day-High",12,1832,11,1,6,FALSE
"2648",41714,"FOREX_eurpln-minute-High",12,375840,11,1,10,FALSE
"2649",41715,"FOREX_eurhuf-hour-High",12,43825,11,1,3,FALSE
"2650",41716,"FOREX_eurcad-day-Close",12,1834,11,1,6,FALSE
"2651",41717,"FOREX_usdjpy-minute-High",12,375840,11,1,10,FALSE
"2652",41718,"FOREX_audjpy-hour-High",12,43825,11,1,3,FALSE
"2653",41719,"FOREX_eurjpy-day-High",12,1832,11,1,6,FALSE
"2654",41720,"FOREX_eurusd-day-High",12,1837,11,1,6,FALSE
"2655",41721,"FOREX_audcad-day-High",12,1834,11,1,6,FALSE
"2656",41722,"FOREX_usdjpy-day-Close",12,1835,11,1,6,FALSE
"2657",41723,"FOREX_cadchf-hour-High",12,43825,11,1,3,FALSE
"2658",41724,"FOREX_chfjpy-day-Close",12,1832,11,1,6,FALSE
"2659",41725,"FOREX_eurcad-day-High",12,1834,11,1,6,FALSE
"2660",41726,"FOREX_audusd-day-High",12,1834,11,1,6,FALSE
"2661",41727,"FOREX_usdcad-hour-Close",12,43825,11,1,3,FALSE
"2662",41728,"FOREX_cadjpy-minute-High",12,375840,11,1,10,FALSE
"2663",41729,"FOREX_chfjpy-minute-Close",12,375840,11,1,10,FALSE
"2664",41730,"FOREX_usdchf-day-High",12,1835,11,1,6,FALSE
"2665",41731,"FOREX_eursek-day-High",12,1837,11,1,6,FALSE
"2666",41732,"FOREX_usdjpy-minute-Close",12,375840,11,1,10,FALSE
"2667",41733,"FOREX_eurhkd-day-High",12,1832,11,1,6,FALSE
"2668",41734,"FOREX_eurpln-hour-Close",12,43825,11,1,3,FALSE
"2669",41735,"FOREX_eurcad-minute-Close",12,375840,11,1,10,FALSE
"2670",41736,"FOREX_eurhuf-hour-Close",12,43825,11,1,3,FALSE
"2671",41737,"FOREX_audusd-day-Close",12,1834,11,1,6,FALSE
"2672",41738,"FOREX_chfsgd-minute-High",12,375840,11,1,10,FALSE
"2673",41739,"FOREX_eurhkd-hour-High",12,43825,11,1,3,FALSE
"2674",41740,"FOREX_audchf-day-Close",12,1833,11,1,6,FALSE
"2675",41741,"FOREX_eursgd-minute-High",12,375840,11,1,10,FALSE
"2676",41742,"FOREX_eurgbp-hour-High",12,43825,11,1,3,FALSE
"2677",41743,"FOREX_eurpln-minute-Close",12,375840,11,1,10,FALSE
"2678",41744,"FOREX_eurrub-day-High",12,1832,11,1,6,FALSE
"2679",41745,"FOREX_chfjpy-minute-High",12,375840,11,1,10,FALSE
"2680",41746,"FOREX_cadchf-day-High",12,1831,11,1,6,FALSE
"2681",41747,"FOREX_audnzd-minute-Close",12,375840,11,1,10,FALSE
"2682",41748,"FOREX_usddkk-minute-Close",12,375840,11,1,10,FALSE
"2683",41749,"FOREX_gbpusd-minute-High",12,375840,11,1,10,FALSE
"2684",41750,"FOREX_eurhuf-day-Close",12,1834,11,1,6,FALSE
"2685",41751,"FOREX_eurnok-minute-Close",12,375840,11,1,10,FALSE
"2686",41752,"FOREX_eurjpy-minute-Close",12,375840,11,1,10,FALSE
"2687",41753,"FOREX_usdcad-day-High",12,1833,11,1,6,FALSE
"2688",41754,"FOREX_eurjpy-day-Close",12,1832,11,1,6,FALSE
"2689",41755,"FOREX_cadchf-minute-Close",12,375840,11,1,10,FALSE
"2690",41756,"FOREX_audsgd-day-High",12,1832,11,1,6,FALSE
"2691",41757,"FOREX_usdchf-minute-Close",12,375840,11,1,10,FALSE
"2692",41758,"FOREX_eursgd-hour-Close",12,43825,11,1,3,FALSE
"2693",41759,"FOREX_eurtry-hour-High",12,43825,11,1,3,FALSE
"2694",41760,"FOREX_eurhuf-day-High",12,1834,11,1,6,FALSE
"2695",41761,"FOREX_eursek-minute-Close",12,375840,11,1,10,FALSE
"2696",41762,"FOREX_audsgd-hour-Close",12,43825,11,1,3,FALSE
"2697",41763,"FOREX_audcad-hour-High",12,43825,11,1,3,FALSE
"2698",41764,"FOREX_gbpusd-day-High",12,1834,11,1,6,FALSE
"2699",41765,"FOREX_eurtry-day-Close",12,1832,11,1,6,FALSE
"2700",41766,"FOREX_eurgbp-day-High",12,1835,11,1,6,FALSE
"2701",41767,"FOREX_cadjpy-hour-Close",12,43825,11,1,3,FALSE
"2702",41768,"FOREX_eurnok-hour-High",12,43825,11,1,3,FALSE
"2703",41769,"FOREX_audcad-day-Close",12,1834,11,1,6,FALSE
"2704",41770,"FOREX_audjpy-minute-High",12,375840,11,1,10,FALSE
"2705",41771,"FOREX_eurtry-minute-Close",12,375840,11,1,10,FALSE
"2706",41772,"FOREX_audchf-minute-High",12,375840,11,1,10,FALSE
"2707",41773,"FOREX_eurtry-hour-Close",12,43825,11,1,3,FALSE
"2708",41774,"FOREX_eurhuf-minute-High",12,375840,11,1,10,FALSE
"2709",41775,"FOREX_usdcad-minute-Close",12,375840,11,1,10,FALSE
"2710",41776,"FOREX_eurhkd-minute-Close",12,375840,11,1,10,FALSE
"2711",41777,"FOREX_eurjpy-hour-High",12,43825,11,1,3,FALSE
"2712",41778,"FOREX_eurdkk-minute-High",12,375840,11,1,10,FALSE
"2713",41779,"FOREX_eursek-hour-High",12,43825,11,1,3,FALSE
"2714",41780,"FOREX_usdchf-hour-High",12,43825,11,1,3,FALSE
"2715",41781,"FOREX_audcad-hour-Close",12,43825,11,1,3,FALSE
"2716",41782,"FOREX_usdjpy-hour-Close",12,43825,11,1,3,FALSE
"2717",41783,"FOREX_eurdkk-day-Close",12,1836,11,1,6,FALSE
"2718",41784,"FOREX_gbpusd-day-Close",12,1834,11,1,6,FALSE
"2719",41785,"FOREX_eurtry-day-High",12,1832,11,1,6,FALSE
"2720",41786,"FOREX_eurgbp-minute-Close",12,375840,11,1,10,FALSE
"2721",41787,"FOREX_eurpln-hour-High",12,43825,11,1,3,FALSE
"2722",41788,"FOREX_audnzd-day-High",12,1832,11,1,6,FALSE
"2723",41789,"FOREX_eurnzd-minute-High",12,375840,11,1,10,FALSE
"2724",41790,"FOREX_cadjpy-day-Close",12,1834,11,1,6,FALSE
"2725",41791,"FOREX_eurusd-day-Close",12,1837,11,1,6,FALSE
"2726",41792,"FOREX_usdchf-hour-Close",12,43825,11,1,3,FALSE
"2727",41793,"FOREX_eurjpy-minute-High",12,375840,11,1,10,FALSE
"2728",41794,"FOREX_nzdusd-minute-Close",12,375840,11,1,10,FALSE
"2729",41795,"FOREX_gbpusd-minute-Close",12,375840,11,1,10,FALSE
"2730",41796,"FOREX_eurrub-minute-Close",12,375840,11,1,10,FALSE
"2731",41797,"FOREX_usdjpy-day-High",12,1835,11,1,6,FALSE
"2732",41798,"FOREX_usdcad-minute-High",12,375840,11,1,10,FALSE
"2733",41799,"FOREX_eurhkd-hour-Close",12,43825,11,1,3,FALSE
"2734",41800,"FOREX_cadjpy-minute-Close",12,375840,11,1,10,FALSE
"2735",41801,"FOREX_eursgd-day-High",12,1832,11,1,6,FALSE
"2736",41802,"FOREX_audcad-minute-High",12,375840,11,1,10,FALSE
"2737",41803,"FOREX_eurchf-day-High",12,1833,11,1,6,FALSE
"2738",41804,"FOREX_gbpusd-hour-Close",12,43825,11,1,3,FALSE
"2739",41805,"FOREX_eurrub-hour-High",12,43825,11,1,3,FALSE
"2740",41806,"FOREX_audjpy-hour-Close",12,43825,11,1,3,FALSE
"2741",41807,"FOREX_nzdusd-minute-High",12,375840,11,1,10,FALSE
"2742",41808,"FOREX_eurgbp-minute-High",12,375840,11,1,10,FALSE
"2743",41809,"FOREX_audusd-minute-High",12,375840,11,1,10,FALSE
"2744",41810,"FOREX_audchf-minute-Close",12,375840,11,1,10,FALSE
"2745",41811,"FOREX_cadchf-day-Close",12,1831,11,1,6,FALSE
"2746",41812,"FOREX_eurnok-day-Close",12,1837,11,1,6,FALSE
"2747",41813,"FOREX_audsgd-minute-Close",12,375840,11,1,10,FALSE
"2748",41814,"FOREX_euraud-minute-Close",12,375840,11,1,10,FALSE
"2749",41815,"FOREX_eurrub-day-Close",12,1832,11,1,6,FALSE
"2750",41816,"FOREX_usddkk-hour-High",12,43825,11,1,3,FALSE
"2751",41817,"FOREX_audusd-minute-Close",12,375840,11,1,10,FALSE
"2752",41818,"FOREX_euraud-day-Close",12,1834,11,1,6,FALSE
"2753",41819,"FOREX_eurrub-minute-High",12,375840,11,1,10,FALSE
"2754",41820,"FOREX_chfsgd-hour-High",12,43825,11,1,3,FALSE
"2755",41821,"FOREX_eurpln-day-Close",12,1832,11,1,6,FALSE
"2756",41822,"FOREX_audnzd-minute-High",12,375840,11,1,10,FALSE
"2757",41823,"FOREX_eurcad-minute-High",12,375840,11,1,10,FALSE
"2758",41824,"FOREX_eurgbp-hour-Close",12,43825,11,1,3,FALSE
"2759",41825,"FOREX_audnzd-hour-High",12,43825,11,1,3,FALSE
"2760",41826,"FOREX_eurnzd-day-Close",12,1832,11,1,6,FALSE
"2761",41827,"FOREX_euraud-hour-Close",12,43825,11,1,3,FALSE
"2762",41828,"FOREX_usdcad-hour-High",12,43825,11,1,3,FALSE
"2763",41829,"FOREX_nzdusd-day-Close",12,1828,11,1,6,FALSE
"2764",41830,"FOREX_nzdusd-day-High",12,1828,11,1,6,FALSE
"2765",41831,"FOREX_eurdkk-hour-Close",12,43825,11,1,3,FALSE
"2766",41832,"FOREX_nzdusd-hour-Close",12,43825,11,1,3,FALSE
"2767",41833,"FOREX_cadjpy-hour-High",12,43825,11,1,3,FALSE
"2768",41834,"FOREX_usdcad-day-Close",12,1833,11,1,6,FALSE
"2769",41835,"FOREX_euraud-hour-High",12,43825,11,1,3,FALSE
"2770",41836,"FOREX_cadchf-minute-High",12,375840,11,1,10,FALSE
"2771",41837,"FOREX_audjpy-minute-Close",12,375840,11,1,10,FALSE
"2772",41838,"FOREX_cadchf-hour-Close",12,43825,11,1,3,FALSE
"2773",41839,"FOREX_cadjpy-day-High",12,1834,11,1,6,FALSE
"2774",41840,"FOREX_eurnok-minute-High",12,375840,11,1,10,FALSE
"2775",41841,"FOREX_chfsgd-day-Close",12,1832,11,1,6,FALSE
"2776",41842,"FOREX_eurchf-hour-High",12,43825,11,1,3,FALSE
"2777",41843,"FOREX_audusd-hour-High",12,43825,11,1,3,FALSE
"2778",41844,"FOREX_eurgbp-day-Close",12,1835,11,1,6,FALSE
"2779",41845,"FOREX_eurusd-minute-High",12,375840,11,1,10,FALSE
"2780",41846,"FOREX_eursek-day-Close",12,1837,11,1,6,FALSE
"2781",41847,"FOREX_eurdkk-day-High",12,1836,11,1,6,FALSE
"2782",41848,"FOREX_chfjpy-day-High",12,1832,11,1,6,FALSE
"2783",41849,"FOREX_audsgd-day-Close",12,1832,11,1,6,FALSE
"2784",41850,"FOREX_eursek-minute-High",12,375840,11,1,10,FALSE
"2785",41851,"FOREX_usdjpy-hour-High",12,43825,11,1,3,FALSE
"2786",41852,"FOREX_eurchf-minute-High",12,375840,11,1,10,FALSE
"2787",41853,"FOREX_eurnzd-minute-Close",12,375840,11,1,10,FALSE
"2788",41854,"FOREX_audcad-minute-Close",12,375840,11,1,10,FALSE
"2789",41855,"FOREX_eurtry-minute-High",12,375840,11,1,10,FALSE
"2790",41856,"FOREX_eurdkk-hour-High",12,43825,11,1,3,FALSE
"2791",41857,"FOREX_audjpy-day-Close",12,1832,11,1,6,FALSE
"2792",41858,"FOREX_usdchf-day-Close",12,1835,11,1,6,FALSE
"2793",41859,"FOREX_eurnok-hour-Close",12,43825,11,1,3,FALSE
"2794",41860,"FOREX_eurusd-hour-Close",12,43825,11,1,3,FALSE
"2795",41861,"FOREX_euraud-minute-High",12,375840,11,1,10,FALSE
"2796",41862,"FOREX_eurrub-hour-Close",12,43825,11,1,3,FALSE
"2797",41863,"FOREX_eurnok-day-High",12,1837,11,1,6,FALSE
"2798",41864,"FOREX_chfsgd-day-High",12,1832,11,1,6,FALSE
"2799",41865,"FOREX_audsgd-hour-High",12,43825,11,1,3,FALSE
"2800",41866,"FOREX_euraud-day-High",12,1834,11,1,6,FALSE
"2801",41867,"FOREX_audnzd-day-Close",12,1832,11,1,6,FALSE
"2802",41868,"FOREX_eurpln-day-High",12,1832,11,1,6,FALSE
"2803",41869,"FOREX_eursgd-minute-Close",12,375840,11,1,10,FALSE
"2804",41870,"FOREX_chfjpy-hour-Close",12,43825,11,1,3,FALSE
"2805",41871,"FOREX_usddkk-hour-Close",12,43825,11,1,3,FALSE
"2806",41872,"FOREX_eurhkd-day-Close",12,1832,11,1,6,FALSE
"2807",41873,"FOREX_eurusd-hour-High",12,43825,11,1,3,FALSE
"2808",41874,"FOREX_eursgd-day-Close",12,1832,11,1,6,FALSE
"2809",41875,"FOREX_audchf-day-High",12,1833,11,1,6,FALSE
"2810",41876,"FOREX_eurdkk-minute-Close",12,375840,11,1,10,FALSE
"2811",41877,"FOREX_eurchf-hour-Close",12,43825,11,1,3,FALSE
"2812",41878,"FOREX_audusd-hour-Close",12,43825,11,1,3,FALSE
"2813",41879,"FOREX_gbpusd-hour-High",12,43825,11,1,3,FALSE
"2814",41880,"FOREX_chfsgd-minute-Close",12,375840,11,1,10,FALSE
"2815",41881,"FOREX_chfjpy-hour-High",12,43825,11,1,3,FALSE
"2816",41882,"FOREX_audjpy-day-High",12,1832,11,1,6,FALSE
"2817",41883,"FOREX_eurnzd-hour-High",12,43825,11,1,3,FALSE
"2818",41884,"FOREX_nzdusd-hour-High",12,43825,11,1,3,FALSE
"2819",41885,"FOREX_chfsgd-hour-Close",12,43825,11,1,3,FALSE
"2820",41886,"FOREX_eurnzd-hour-Close",12,43825,11,1,3,FALSE
"2821",41887,"FOREX_audsgd-minute-High",12,375840,11,1,10,FALSE
"2822",41888,"FOREX_audchf-hour-Close",12,43825,11,1,3,FALSE
"2823",41889,"FOREX_eurjpy-hour-Close",12,43825,11,1,3,FALSE
"2824",41890,"FOREX_usddkk-minute-High",12,375840,11,1,10,FALSE
"2825",41891,"FOREX_eurcad-hour-Close",12,43825,11,1,3,FALSE
"2826",41892,"FOREX_usdchf-minute-High",12,375840,11,1,10,FALSE
"2827",41893,"FOREX_eursgd-hour-High",12,43825,11,1,3,FALSE
"2828",41894,"FOREX_eurchf-day-Close",12,1833,11,1,6,FALSE
"2829",41895,"FOREX_eurhuf-minute-Close",12,375840,11,1,10,FALSE
"2830",41896,"FOREX_eursek-hour-Close",12,43825,11,1,3,FALSE
"2831",41897,"FOREX_usddkk-day-Close",12,1832,11,1,6,FALSE
"2832",41898,"FOREX_audnzd-hour-Close",12,43825,11,1,3,FALSE
"2844",41945,"ilpd-numeric",11,583,10,1,6,FALSE
"2845",41946,"Sick_numeric",30,3772,29,1,6,FALSE
"2846",41949,"Elegibilidade",2,269177,0,1,10,FALSE
"2853",41964,"USPS",257,1424,256,1,2,FALSE
"2854",41966,"isolet",618,600,617,1,13,FALSE
"2855",41967,"cnae-9",857,240,856,1,13,FALSE
"2860",41973,"semeion",257,319,256,1,2,FALSE
"2861",41976,"TuningSVMs",81,156,80,1,6,FALSE
"2955",42172,"regime_alimentaire",20,202,3,17,11,TRUE
"2959",42178,"telco-customer-churn",20,7043,3,0,4,FALSE
"2965",42192,"compas-two-years",14,5278,7,7,8,FALSE
"2978",42206,"porto-seguro",38,595212,12,26,12,TRUE
"2989",42252,"Asteroid_Dataset",34,126131,31,2,3,TRUE
"3000",42343,"KDD98",478,82318,341,137,13,FALSE
"3001",42344,"sf-police-incidents",7,538638,1,6,12,FALSE
"3021",42395,"SantanderCustomerSatisfaction",202,200000,200,1,3,FALSE
"3023",42397,"CreditCardFraudDetection",31,284807,30,1,10,FALSE
"3076",42477,"default-of-credit-card-clients",24,30000,23,1,3,FALSE
"3106",42554,"test_hate_vects",50,4,48,2,6,FALSE
